7333333336
2000000004
201A00A104
20A0000A04
2000000004
2000000004
20A0000A04
201A00A104
2000000004
9555555558